1 1 1 1 11 111111
1101010101 100111
1000000001 101 
10000000001101
10000111000001
10000000000001
10000000000001
11111000111000111
1   10001  10001
111111001  10S1
     1111  1111
