11111111111111111
1             1S1
11111111111111111
