111111111111111
100100000000001
100100000000001
1000W0000000001
100000001000001
100000001000001
100000001000001
100000001000001
111111111111111
